#.#.#.#.#.##
.@........
#########.#
..........
#.#########
..........
#########.#
..........
#.###.#####
..........
#
###########