#..#######
#..#@....#
#.#.###..#
#......#.#
##...##..#
#..##..#.#
##.......#
#..#######
##.......#
##########
