...###
..##.#.####
.....###..#
##........#
#......#..#
###..###..#
..#..#....#
.##.##.#.##
.#......##
.#..@..##
.#######