####..####
#@.......
#....#...
#........
..#..#..
........
#.#...#..
#.##.....
#........
#